*!!!!!!*!!!!!!*!!!!!!*!!!!!!*
!!*!!*!!!*!!*!!!*!!*!!!*!!*!!
!!!**!!!!!**!!!!!**!!!!!**!!!
!!*!!*!!!*!!*!!!*!!*!!!*!!*!!
*!!!!!!*!!!!!!*!!!!!!*!!!!!!*
!!*!!*!!!*!!*!!!*!!*!!!*!!*!!
!!!**!!!!!**!!!!!**!!!!!**!!!
!!*!!*!!!*!!*!!!*!!*!!!*!!*!!
*!!!!!!*!!!!!!*!!!!!!*!!!!!!*
!!*!!*!!!*!!*!!!*!!*!!!*!!*!!
!!!**!!!!!**!!!!!**!!!!!**!!!
!!*!!*!!!*!!*!!!*!!*!!!*!!*!!
*!!!!!!*!!!!!!*!!!!!!*!!!!!!*
